#######
#.p...#
#..m..#
#...$.#
#######