..................
........$....m....
..####............
..#p....$....m....
..####............
........$....m....
..................